0000100111000010010011100
0001001011000111101111010
1010101101100111010100010
1111010111010011111011001
1110110101001110110011001
0100100001010001110100011
1001001110000110100001111
1001100100111111011110111
1010110110000110010011101
0010001001110101101010110
1100110111001101100001111
0001001001011111111111000
1000110100101011110101111
0100010111010100110101100
0011111001111111001111111
1100001011111001011001101
0000000111000000001100000
1010000100001000100101000
0010011111011001101101001
1001010011101001111110011
1010001011110011001010101
1110001000010111110101110
1001110010001101110010110
0001111000110001000101000
1000110001111011011000100
